##################################################
#O##.OO.O........OO.#...OO#.......O..O.....O....O#
#OO......O..OOO.O#...O....O#.O#.O##...........OO.#
#....OO##O.O....OO.OO.OO...OO#..O.O.O.#.....#.O#.#
#..#..O.O#..O...OO..O..O.....OOO#.O........O.O#O.#
#O.#.#OO..#.......O.O..OOOO.O.....O.O............#
#........OO...O.#.O..O.....O.O.O.O...O..O....OOOO#
#.#OO..O....#..#.....O....#.OO....#..#.OO..O.O...#
#....OOO....O.......#.#OO.......O......OO..O#O.#O#
#...##.O....O..O.O..#..OO.O...O...O..OO....O#...##
##OO.O....O....O..OO....O....O##O.O..O.....#.OO..#
#..O........O..O...#.OOO.OO...O..#OO....O....O...#
#..........OO..O..#O.............#O.O#.#.O....O.O#
#...O.OO.......OO.........O.OOO...O.OO...OO..OO.O#
#.O..O.OO..#.....................O...O......O..O.#
##OO#.O.#...O.....OO..O.........O#....OO...O#....#
#.O.#..O.OOOO.O...O.O.OOOO..O...#......#O.O..OO.O#
#...OO....OOOO.OO.#.#O..O..OO.........O.O.......O#
#...#...#.O#....O.#O....O.O.O......OO..OO......O.#
#.O#.#O..#O...OO..O......O..O..O.O...O..O...O...O#
#.......O........OOO....O..#O#.....O#............#
#.OOOO......#........#...O..O..#......O..O.O..#..#
#OOO...O...O..OO.O..O.#O.......O....O#..#.O..O...#
#..O...##.O.OO#..O..O..O.....O...................#
##O......OO.O...OO#.O.#.@...O...O...........#..O.#
#O.O..OO.O..O......O.OO......OOO.....#..OOO..O...#
#....O....O.O.......#.O..O....#..#...O..O..O.OO.O#
#.......OO..O.....O..O#.O...OOO.O.O...OO#..O..O..#
#..#.#O.....OO..O.O..O......O#.OOOO...O.O.OO.O#..#
#..O.....O.#O#.....#O..OOO.OO.O.......O.O.O.O....#
#OO#O..##......O.O...O#.OO.....O....O.....O.#..O.#
#..#O....O..O.O#.#..#O.#O.#....#..O...#.O..OO.O..#
#OO.....#O....O.#O..O.OO..O.##O.O..O..O.OO.O.##..#
#O.OO.............O...O..#....O.O.OO....#O.OO...O#
#.....O#......O.O.O..O...O#O..O.#..OO.....#..O.O.#
#.OO..O.O..O....O#...#..OO.O.##.....O..#O..O...O.#
#O..O..#.#..#.....O....O.....O.##.#.......O......#
#O....O.....O..#.#OO.OO.#...........#.#.#O.....O##
#...O.....O..#......O.O.O.OO..O#.O#...OOO.OO..#..#
#....O.O.#O....#.......O.......#....O...O..O.....#
#.......O#....O..OOO.#OO..#...OO#....OO.OOO.....O#
#....#O.O.#OO.OO..O..O...#O.##.#O...O.#...O.O..O.#
#O.O...OOO.OO.#O.....O.........#OO.O....#.O......#
#.O.O.......O....OO......O..O.O.....O...O........#
#O#..#O#......#.O.......OO...............O....O#.#
#..O.OO.....O.O.O#O.O.OO.OO.O.....#O##..#O.#...O##
#..OO#.O..#.O.O.#O..O...O.#.#O..O....O....#O..O..#
#.O...O#.OO.......#.O..O...#.#OO.#..O.O...OO#O.O.#
#.....OO#....O....O.O...O..OOO......O....O#.....O#
##################################################